   ##########   
   #II  #   #   
   #II      #   
   #II  #  #### 
  #######  #  ##
  #            #
  #  #  ##  #  #
#### ##  #### ##
#  C  ##### #  #
# # C  C  # C  #
# PC  C   #   ##
#### ## ####### 
   #    #       
   ######  