######     ####    
#    #######  #####
#   C#  #  C  #   #
#  C  C  C # C C  #
##C C   # P# C    #
#  C ########### ##
# #   #IIIIIII# C# 
# ##  # IIIIII#  # 
# #   CIIIIIIIIC # 
# # C #IIII II#  # 
#  C C####C#### C# 
# C   ### C   C  ##
# C     C C  C    #
## ###### C ##### #
#         #       #
###################
