    #####             
    #   #             
    #C  #             
  ###  C###           
  #  C  C #           
### # ### #     ######
#   # ### #######  II#
# C  C             II#
##### #### #P####  II#
    #      ###  ######
    ########