        ######## 
        #     P# 
        # C#C ## 
        # C  C#  
        ##C C #  
######### C # ###
#IIII  ## C  C  #
##III    C  C   #
#IIII  ##########
########  