              ########
              #  IIII#
   ############  IIII#
   #    #  C C   IIII#
   # CCC#C  C #  IIII#
   #  C     C #  IIII#
   # CC #C C C########
####  C #     #       
#   # #########       
#    C  ##            
# CC#CC P#            
#   #   ##            
######### 