        #####    
        #   #####
        # #C##  #
        #     C #
######### ###   #
#IIII  ## C  C###
#IIII    C CC ## 
#IIII  ##C  C P# 
#########  C  ## 
        # C C  # 
        ### ## # 
          #    # 
          ###### 